#8#25#
7 8 8 6 7 8 8 6 
5 8 6 9 5 6 7 10 
9 12 5 4 10 9 11 6 
9 5 1 8 6 9 7 3 
9 9 11 14 9 5 3 9 
5 10 7 6 11 10 11 3 
9 7m 3m 9 13 6 7 10 
15s 11m 10m 11 8 4 4 14 
