#16#50#
12 12 12 7 8 8 8 8 8 8 8 8 8 8 8 6 
9 9 5 3 7 8 8 8 8 8 8 8 8 8 8 3 
11 1 3 9 9 13 8 8 6 7 8 8 8 8 6 9 
7 10 9 9 9 7 8 8 1 10 7 8 8 8 3 9 
5 8 10 9 9 5 8 2 4 6 11 8 8 6 9 9 
5 8 8 10 9 9 7 4 14 15 7 8 8 10 9 9 
9 7 8 8 10 5 1 14 7 6 11 8 8 6 9 9 
9 5 8 8 8 10 15 7m 3m 5 8 8 8 10 15 9 
9 9 7 8 8 6 12 11m 10m 5 2 8 2 8 2 3 
9 11 4 8 6 9 5 8 8 10 11 2 1 8 3 9 
5 8 8 6 9 9 11 8 8 8 8 10 11 8 3 9 
5 8 6 9 9 9 7 8 8 8 8 8 8 8 4 3 
11 6 9 9 9 9 11 8 8 8 8 8 8 8 6 9 
7 1 3 9 9 11 8 8 8 8 8 8 8 8 10 15 
9 9 5 3 11 8 8 8 8 8 8 8 8 8 8 6 
15s 15 15 11 8 8 8 8 8 8 8 8 8 8 8 10 
