#16#47#
7 8 2 2 8 14 7 2 2 8 8 8 8 8 8 6 
9 7 10 5 8 2 3 15 5 8 8 8 8 8 6 9 
9 11 6 9 7 3 11 8 10 7 8 8 8 8 10 9 
9 7 10 11 3 15 7 8 8 4 8 8 8 8 6 9 
9 9 7 6 11 14 5 8 8 8 8 8 8 8 10 9 
9 5 3 11 2 8 10 7 8 8 2 8 8 8 8 10 
11 3 11 14 11 2 6 9 13 6 5 6 7 6 7 6 
7 4 8 8 8 10 9 5m 6m 9 9 11 10 11 3 9 
9 7 8 8 2 6 15 11m 10m 9 11 8 8 6 9 9 
9 9 7 8 4 10 7 8 8 4 8 2 8 10 9 9 
11 3 9 7 8 8 4 8 8 8 6 11 8 8 3 9 
7 3 9 9 7 8 8 8 8 8 4 8 8 8 3 9 
9 9 9 9 11 8 8 8 8 8 6 7 8 8 4 3 
9 9 9 5 8 8 8 8 8 6 9 11 8 8 6 9 
9 9 11 10 7 2 8 8 8 10 9 7 8 8 10 9 
15s 11 8 8 10 11 8 8 8 8 4 4 8 8 8 10 
