#16#44#
7 8 8 8 8 8 8 8 8 8 8 8 8 8 8 6 
9 7 8 8 8 8 2 2 8 8 8 8 8 8 6 9 
9 9 7 8 8 6 9 5 8 8 2 8 8 6 9 9 
9 9 9 7 6 9 9 9 13 8 4 8 6 9 5 10 
9 9 9 9 9 9 9 11 8 8 8 2 10 9 9 12 
9 9 9 9 9 9 9 7 8 8 6 11 8 3 9 9 
9 9 9 9 9 9 5 10 7 2 4 8 6 11 10 9 
9 9 9 9 9 9 9 7m 3m 9 7 6 9 13 2 10 
9 11 4 10 9 9 9 11m 10m 9 9 9 11 6 11 6 
9 7 2 14 9 9 11 8 8 10 11 4 6 9 7 10 
9 9 11 8 10 9 7 8 8 2 8 2 10 9 11 6 
9 5 6 7 8 10 11 8 8 4 2 4 2 4 2 10 
11 3 5 10 7 8 8 8 8 6 11 2 4 2 4 6 
7 3 9 7 10 7 8 8 6 11 6 11 2 4 2 10 
9 9 5 10 13 4 6 7 4 14 11 6 11 8 4 6 
15s 11 4 8 8 8 10 11 8 8 8 4 8 8 8 10 
