#16#130#
7 8 8 8 8 8 8 8 8 8 8 8 8 8 8 6 
9 7 8 8 8 8 8 8 8 8 2 8 8 8 8 3 
9 9 7 8 8 8 2 8 14 13 4 2 8 8 6 9 
9 9 9 12 7 6 11 8 6 12 7 10 7 8 10 9 
9 9 9 5 10 9 7 6 11 3 9 13 4 8 6 9 
9 9 9 11 6 9 9 11 6 11 10 7 8 8 10 9 
9 9 11 8 10 9 9 13 4 8 6 11 8 6 12 9 
9 9 7 6 13 3 9 7m 2m 6 11 8 8 10 9 9 
9 9 9 11 6 9 9 11m 10m 11 2 14 7 2 3 9 
9 9 9 7 10 5 10 13 2 6 11 6 9 15 9 9 
9 9 9 11 8 10 7 6 9 11 6 11 1 8 3 9 
9 9 11 8 8 6 9 9 11 6 11 6 11 6 9 9 
9 9 7 8 8 10 9 9 13 4 6 11 6 11 3 9 
5 3 9 13 8 8 3 9 13 8 4 6 11 6 9 9 
9 9 11 8 8 8 10 11 8 8 8 10 13 4 10 9 
15s 11 8 8 8 8 8 8 8 8 8 8 8 8 8 10 
