#16#72#
7 8 8 8 8 8 8 8 8 8 8 8 8 8 8 6 
9 7 6 7 6 7 8 8 8 8 8 8 2 8 2 3 
5 3 11 10 11 3 12 7 6 7 6 7 10 7 10 9 
9 11 8 8 6 9 5 3 5 3 5 10 7 10 12 9 
11 8 6 7 10 9 9 11 10 11 10 7 10 7 3 9 
7 6 9 11 6 9 5 6 7 8 6 11 8 10 9 9 
9 9 5 14 9 9 15 11 10 7 4 8 2 6 9 9 
9 5 10 7 10 9 12 7m 6m 5 8 2 3 9 9 9 
9 15 7 10 12 9 5 4m 10m 15 7 10 9 9 9 9 
11 2 10 7 3 9 5 8 8 8 4 6 9 9 9 9 
13 1 14 9 9 9 11 8 8 8 8 4 3 11 3 9 
13 1 14 9 9 5 8 8 8 8 2 6 15 7 10 9 
13 1 14 9 9 15 7 8 6 7 3 5 6 11 6 9 
7 4 8 10 11 2 4 6 11 10 11 3 11 6 9 9 
5 6 7 6 7 3 13 4 8 8 8 1 8 3 9 9 
15s 11 10 11 10 11 8 8 8 8 8 4 8 10 11 10 
